11111111111111
1001111X00C001
10000000000011
1P00C11110CC01
10X001E0000C01
100C11111000C1
10CCC11X110001
110000C0000111
1111000C011111
11111111111111
