11111111111
100100000C1
1000011100111
1P0011E000001
1111111111111
